###############
#_______A___###
#_.__P____C_G_#
#______-___E__#
#_Z_E______BB_#
#####__#_######
#####__#_######
#__##K__P__####
#__E#__@______#
#_A________F__#
#___D__##C__L_#
#______##E____#
###############