###############
#_______a___###
#_.__p____c_g_#
#______-___e__#
#_z_e______bb_#
#####__#_######
#####__#_######
#__##k__p__####
#__e#__@______#
#_a________f__#
#___d__##c__l_#
#______##E____#
###############